.....................................................................................................
.....................................................................................................
.....................................................................................................
.....................................................................................................
.....................................................................................................
.....................................................................................................
.....................................................................................................
.....................................................................................................
.....................................................................................................
...........................@@@@@@@@@@@@@@@@@@@@@@....................................................
...........................@@@@@@@@@@@@@@@@@@@@@@....................................................
...........................@@@@@@@@@@@@@@@@@@@@@@....................................................
...........................@@@@@@@@@@@@@@@@@@@@@@....................................................
...........................@@@@@@@@@@@@@@@@@@@@@@....................................................
...........................@@@@@@@@@@@@@@@@@@@@@@....................................................
...........................@@@@@@@@@@@@@@@@@@@@@@....................................................
...........................@@@@@@@@@@@@@@@@@@@@@@....................................................
...........................@@@@@@@@@@@@@@@@@@@@@@....................................................
...........................@@@@@@@@@@@@@@@@@@@@@@....................................................
...........................@@@@@@@@@@@@@@@@@@@@@@....................................................
.....................................................................................................
.....................................................................................................
.....................................................................................................
.....................................................................................................
.....................................................................................................
.....................................................................................................
...............................................@@@@@@@@@@@@@@@.......................................
...............................................@@@@@@@@@@@@@@@.......................................
...............................................@@@@@@@@@@@@@@@.......................................
...............................................@@@@@@@@@@@@@@@.......................................
...............................................@@@@@@@@@@@@@@@.......................................
...............................................@@@@@@@@@@@@@@@.......................................
...............................................@@@@@@@@@@@@@@@.......................................
...............................................@@@@@@@@@@@@@@@.......................................
...............................................@@@@@@@@@@@@@@@.......................................
...............................................@@@@@@@@@@@@@@@.......................................
...............................................@@@@@@@@@@@@@@@.......................................
...............................................@@@@@@@@@@@@@@@.......................................
.....................................................................................................
.....................................................................................................
.....................................................................................................
......................@@@@@@@@@@@@@@@@@@@@@@@@@......................................................
......................@@@@@@@@@@@@@@@@@@@@@@@@@......................................................
......................@@@@@@@@@@@@@@@@@@@@@@@@@......................................................
......................@@@@@@@@@@@@@@@@@@@@@@@@@......................................................
......................@@@@@@@@@@@@@@@@@@@@@@@@@......................................................
......................@@@@@@@@@@@@@@@@@@@@@@@@@......................................................
......................@@@@@@@@@@@@@@@@@@@@@@@@@...................@@@@@@@@@@@@@@@@@..................
......................@@@@@@@@@@@@@@@@@@@@@@@@@...................@@@@@@@@@@@@@@@@@..................
......................@@@@@@@@@@@@@@@@@@@@@@@@@...................@@@@@@@@@@@@@@@@@..................
......................@@@@@@@@@@@@@@@@@@@@@@@@@...................@@@@@@@@@@@@@@@@@..................
......................@@@@@@@@@@@@@@@@@@@@@@@@@...................@@@@@@@@@@@@@@@@@..................
......................@@@@@@@@@@@@@@@@@@@@@@@@@...................@@@@@@@@@@@@@@@@@..................
......................@@@@@@@@@@@@@@@@@@@@@@@@@...................@@@@@@@@@@@@@@@@@..................
..................................................................@@@@@@@@@@@@@@@@@..................
..................................................................@@@@@@@@@@@@@@@@@..................
..................................................................@@@@@@@@@@@@@@@@@..................
..................................................................@@@@@@@@@@@@@@@@@..................
..................................................................@@@@@@@@@@@@@@@@@..................
..................................................................@@@@@@@@@@@@@@@@@..................
..................................................................@@@@@@@@@@@@@@@@@..................
..................................................................@@@@@@@@@@@@@@@@@..................
..................................................................@@@@@@@@@@@@@@@@@..................
..................................................................@@@@@@@@@@@@@@@@@..................
..................................................................@@@@@@@@@@@@@@@@@..................
..................................................................@@@@@@@@@@@@@@@@@..................
.....................................................................................................
..........................@@@@@@@@@@@@@@@@@@@@@......................................................
..........................@@@@@@@@@@@@@@@@@@@@@......................................................
..........................@@@@@@@@@@@@@@@@@@@@@......................................................
..........................@@@@@@@@@@@@@@@@@@@@@......................................................
..........................@@@@@@@@@@@@@@@@@@@@@......................................................
..........................@@@@@@@@@@@@@@@@@@@@@......................................................
..........................@@@@@@@@@@@@@@@@@@@@@......................................................
..........................@@@@@@@@@@@@@@@@@@@@@......................................................
..........................@@@@@@@@@@@@@@@@@@@@@......................................................
..........................@@@@@@@@@@@@@@@@@@@@@......................................................
..........................@@@@@@@@@@@@@@@@@@@@@......................................................
..........................@@@@@@@@@@@@@@@@@@@@@......................................................
..........................@@@@@@@@@@@@@@@@@@@@@......................................................
..........................@@@@@@@@@@@@@@@@@@@@@......................................................
..........................@@@@@@@@@@@@@@@@@@@@@......................................................
.....................................................................................................
.....................................................................................................
.....................................................................................................
......................................................@@@@@@@@@@@@@@@@@@@@@@@........................
......................................................@@@@@@@@@@@@@@@@@@@@@@@........................
......................................................@@@@@@@@@@@@@@@@@@@@@@@........................
......................................................@@@@@@@@@@@@@@@@@@@@@@@........................
......................................................@@@@@@@@@@@@@@@@@@@@@@@........................
......................................................@@@@@@@@@@@@@@@@@@@@@@@........................
......................................................@@@@@@@@@@@@@@@@@@@@@@@........................
.....................................................................................................
.....................................................................................................
.....................................................................................................
.....................................................................................................
.....................................................................................................
.....................................................................................................
.....................................................................................................
.....................................................................................................
.....................................................................................................