@@@@@@@@@.@@@@@@@.@@@@@@@@@@.@@@@@@@@@@@@@@@@@@@@@@@@@@@@@@@@@@@@@.@@@@@@@@@@@@.@@@@@.@@@@@@@@@@@@@*
@.........@.........@.........@.........@.........@.........@...................@.........@.........
@.........@.........@.........@.........@.........@...................@.........@.........@.........
@.........@.........@.........@.........@.........@.........@.........@.........@.........@.........
..........@.........@...................@.........@.........@.........@.........@.........@.........
@.........@.........@.........@.........@...................@.........@.........@.........@.........
@.........@.........@.........@.........@.........@.........@.........@.........@.........@.........
@...................@.........@...................@.........@.........@...................@.........
@.........@...................@.........@.........@.........@.........@.........@.........@.........
@.........@.........@.........@.........@.........@.........@.........@.........@...................
@@@@@@@@@@@@@@@@@@@@@@@@@@@@@@@@@@@@@@@@@@@@@@@@@@@@@@@@@@@@@@@@@@@@@.@@@@@@@@.@@@@@@.@@@@@@@@@@.@@@
@.........@.........@.........@.........@.........@.........@.........@.........@.........@.........
@...................@.............................@...................@.........@.........@.........
@.........@.........@.........@.........@.........@.........@.........@.........@.........@.........
@.........@.........@.........@.........@.........@.........@.........@.........@.........@.........
@.........@.........@.........@.........@.........@.........@.........@.........@.........@.........
@.........@.........@.........@.........@.........@.........@.........@.........@.........@.........
@.........@...................@.........@.........@.........@...................@...................
@.........@.........@.........@.........@.........@.........@.........@.........@.........@.........
..........@.........@.........@.........@...................@.........@...................@.........
@@@@@@@@@@@@@@@.@@@@@@@@@@@@@@@@@@@.@@@@@@@@@@@@.@@@@@@@@@@@@@@.@@@@@@@@@@@@@@@@@@@@@@@@@@@@@@@@@.@@
@.........@.........@.........@.........@.........@.........@...................@.........@.........
@.........@.........@...................@.........@...................@.........@.........@.........
@.........@.........@.........@.........@...................@.........@.........@.........@.........
..........@.........@.........@.........@.........@.........@.........@.........@...................
@.........@.........@.........@...................@.........@.........@.........@.........@.........
@.........@...................@.........@.........@.........@.........@.........@.........@.........
@.........@.........@.........@.........@.........@.........@.........@.........@.........@.........
@...................@.........@.........@.........@.........@.........@...................@.........
@.........@.........@.........@.........@.........@.........@.........@.........@.........@.........
@@@@@@@@@@@@@.@@@@@@@@@@@@@@@@@@@@@@@@@@@@@@@@@@@@@@@@@@@@@@@@@@@@@@@@@@@@@@@@@@@@@@@@@@@@@@@@@@@@@@
@.........@.........@.........@.........@.........@.........@.........@.........@.........@.........
@.........@.........@.........@.........@.........@.........@.........@.........@.........@.........
@.........@.........@.........@.........@.........@.........@.........@.........@.........@.........
@.........@.........@.........@...................@.........@.........@.........@.........@.........
@.........@...................@.........@.........@...................@.........@...................
..........@.........@.........@.........@.........@.........@.........@...................@.........
@...................@.........@.........@.........@.........@.........@.........@.........@.........
@.........@.........@.........@.........@...................@.........@.........@.........@.........
@.........@.........@...................@.........@.........@...................@.........@.........
@@@@@@@@@@@@@@@@@@@@@@@@@@@@@@@@@@@@@@@@@@@@@@@@@@@@@@@@@@@@@@@@@@@@@@@@@@@@@@@@@@@@@@@@@@@@@@@@.@@@
@.........@.........@.........@.........@.........@.........@.........@.........@.........@.........
@...................@.........@.........@.........@...................@.........@.........@.........
@.........@.........@.........@.........@...................@.........@...................@.........
@.........@.........@.............................@.........@.........@.........@...................
@.........@.........@.........@.........@.........@.........@.........@.........@.........@.........
@.........@.........@.........@.........@.........@.........@...................@.........@.........
@.........@.........@.........@.........@.........@.........@.........@.........@.........@.........
@.........@.........@.........@.........@.........@.........@.........@.........@.........@.........
..........@...................@.........@.........@.........@.........@.........@.........@.........
@@@@@@@@@.@@@@@@@.@@@@@@@@@@.@@@@@@@@@@@@@@@@@@@@@@@@@@@@@@@@@@@@@.@@@@@@@@@@@@.@@@@@.@@@@@@@@@@@@@*
@.........@.........@.........@.........@.........@.........@...................@.........@.........
@.........@.........@.........@.........@.........@...................@.........@.........@.........
@.........@.........@.........@.........@.........@.........@.........@.........@.........@.........
..........@.........@...................@.........@.........@.........@.........@.........@.........
@.........@.........@.........@.........@...................@.........@.........@.........@.........
@.........@.........@.........@.........@.........@.........@.........@.........@.........@.........
@...................@.........@...................@.........@.........@...................@.........
@.........@...................@.........@.........@.........@.........@.........@.........@.........
@.........@.........@.........@.........@.........@.........@.........@.........@...................
@@@@@@@@@@@@@@@@@@@@@@@@@@@@@@@@@@@@@@@@@@@@@@@@@@@@@@@@@@@@@@@@@@@@@.@@@@@@@@.@@@@@@.@@@@@@@@@@.@@@
@.........@.........@.........@.........@.........@.........@.........@.........@.........@.........
@...................@.............................@...................@.........@.........@.........
@.........@.........@.........@.........@.........@.........@.........@.........@.........@.........
@.........@.........@.........@.........@.........@.........@.........@.........@.........@.........
@.........@.........@.........@.........@.........@.........@.........@.........@.........@.........
@.........@.........@.........@.........@.........@.........@.........@.........@.........@.........
@.........@...................@.........@.........@.........@...................@...................
@.........@.........@.........@.........@.........@.........@.........@.........@.........@.........
..........@.........@.........@.........@...................@.........@...................@.........
@@@@@@@@@@@@@@@.@@@@@@@@@@@@@@@@@@@.@@@@@@@@@@@@.@@@@@@@@@@@@@@.@@@@@@@@@@@@@@@@@@@@@@@@@@@@@@@@@.@@
@.........@.........@.........@.........@.........@.........@...................@.........@.........
@.........@.........@...................@.........@...................@.........@.........@.........
@.........@.........@.........@.........@...................@.........@.........@.........@.........
..........@.........@.........@.........@.........@.........@.........@.........@...................
@.........@.........@.........@...................@.........@.........@.........@.........@.........
@.........@...................@.........@.........@.........@.........@.........@.........@.........
@.........@.........@.........@.........@.........@.........@.........@.........@.........@.........
@...................@.........@.........@.........@.........@.........@...................@.........
@.........@.........@.........@.........@.........@.........@.........@.........@.........@.........
@@@@@@@@@@@@@.@@@@@@@@@@@@@@@@@@@@@@@@@@@@@@@@@@@@@@@@@@@@@@@@@@@@@@@@@@@@@@@@@@@@@@@@@@@@@@@@@@@@@@
@.........@.........@.........@.........@.........@.........@.........@.........@.........@.........
@.........@.........@.........@.........@.........@.........@.........@.........@.........@.........
@.........@.........@.........@.........@.........@.........@.........@.........@.........@.........
@.........@.........@.........@...................@.........@.........@.........@.........@.........
@.........@...................@.........@.........@...................@.........@...................
..........@.........@.........@.........@.........@.........@.........@...................@.........
@...................@.........@.........@.........@.........@.........@.........@.........@.........
@.........@.........@.........@.........@...................@.........@.........@.........@.........
@.........@.........@...................@.........@.........@...................@.........@.........
@@@@@@@@@@@@@@@@@@@@@@@@@@@@@@@@@@@@@@@@@@@@@@@@@@@@@@@@@@@@@@@@@@@@@@@@@@@@@@@@@@@@@@@@@@@@@@@@.@@@
@.........@.........@.........@.........@.........@.........@.........@.........@.........@.........
@...................@.........@.........@.........@...................@.........@.........@.........
@.........@.........@.........@.........@...................@.........@...................@.........
@.........@.........@.............................@.........@.........@.........@...................
@.........@.........@.........@.........@.........@.........@.........@.........@.........@.........
@.........@.........@.........@.........@.........@.........@...................@.........@.........
@.........@.........@.........@.........@.........@.........@.........@.........@.........@.........
@.........@.........@.........@.........@.........@.........@.........@.........@.........@.........
..........@...................@.........@.........@.........@.........@.........@.........@.........